##############################
#@..#.......#...#...........##
###.#####.#.#.#.#.#########.##
#.#...#...#...#.#.........#.##
#..##...###.###.#####.#####.##
#.....#.#%#...#.#%....#.....##
#.#####.#.#.#.#.#####.#.###.##
#.#.~...#...#.#.#...#%#...#%##
#.#.#.#######.#.#.#.###...####
#.#%#.#%....#.#..~#...#%#...##
#.###.###.#.#..######.#####.##
#.#...#...#.#......%#...#...##
#.#.###.###.#.#.#######.#.####
#...#.....#.....#....~..#...##
#####...#.#####.#.#########.##
#.~...#.#...#...#.#.....#...##
#.###.#.###.#.###.#.###.#.####
#.#.......#.#..%#...#%#.#...##
#.#~#####.#.#########.#.###.##
#...#.#...#.......#.....~...##
#####.#.#########.#.#.#####.##
#...#.~.#...#.~.#...#...#...##
#.#.#.###.#.#.#.#####.###.####
#.#.......#...#.....#......!##
##############################
